{
    "32": "L",
    "35": "L",
    "38": "L",
    "33": "R",
    "36": "R",
    "39": "R"
}